111111
110101
110C01
1P0001
111111