1111111111111111111111
10P010C1C00011C0111C01
10C1C001110011011C1001
10110001E1011100000011
101000110101110C0000C1
1000100001C00000000001
10C0110001111111000C11
1000110000000C00010001
100C1100C1011111100001
100011C00000C001111111
1C000111111000000001C1
10C00000C111C111C00001
1111111100000111111111
1111111111111111111111